############
#       G  #
#    B     #
#P         #
############