############
#P      G  #
#    B     #
#          #
############